1111111111111111111111111111111111111111111111
1000000000000000000000000000000000000011111111
1000000000000000000000000000000000000011111111
1000000000000000000000000000000000000011111111
1000000000000000000000000000000000000011111111
1000000000000000000000000000000000000011111111
1001C00000001111111111111111000000000011111111
1000011111001111111111111111000000000011111111
100011EC00000000000000000001000000000011111111
1111111111111111111111111111CCCCCCCCCC11111111
1111111111111111111111111111000000000011111111
1111111011111111111111111111000000000011111111
1111111111111111111111111111000000000011111111
1111111111111111111111111111000000000011111111
1111111111111111111111111111011100000011111111
1111111111111111111111111111100010000011111111
1111111111111111111111111111001010000011111111
1111111111111111111111111111P10000000011111111
1111111111111111111111111111111111111111111111