111111111111111111111111111111
1001C0000000111111111111111101
100001111100111111111111111101
1P0011EC0000000000000000000101
1111111111111111111111111111C1
111111111111111111111111111101
111111101111111111111111111101
111111111111111111111111111101
111111111111111111111111111111