111111111111111111111
100000000000000000001
100000010001100000001
10000011001C010000001
1000010100001000000C1
100010010001000000E01
100011111010000000001
1000000100111100C0C01
100000000000000C00001
1P1C00000111111111101
111111111111111111111