111111111111111111111111111111111111111111111111111111111111
100000000000000000000000000000000000001111111111111111111111
100000000000000000000000000000000000001111111111111111111111
100000000000000000000000000000000000001111111111111111111111
100000000000000000000000000000000000001111111111111111111111
10000000000000X0000000X0000000000000001111111111111111111111
1001C00X0000111111111111111100000000001111111111111111111111
100001111100111111111111111100000000001111111111111111111111
1000111E0C00000000000000000100000000001111111111111111111111
1111111111111111111111111111CCCCCCCCCC1111111111111111111111
111111111111111111111111111100000000001111111111111111111111
111111101111111111111111111100000000001111111111111111111111
111111111111111111111111111100000000001111111111111111111111
111111111111111111111111111100X000P0001111111111111111111111
111111111111111111111111111101110000001111111111111111111111
111111111111111111111111111110001000001111111111111111111111
111111111111111111111111111100101000001111111111111111111111
111111111111111111111111111101000000001111111111111111111111
111111111111111111111111111111111111111111111111111111111111
111111111111111111111111111111111111111111111111111111111111
111111111111111111111111111111111111111111111111111111111111
111111111111111111111111111111111111111111111111111111111111
111111111111111111111111111111111111111111111111111111111111
111111111111111111111111111111111111111111111111111111111111
111111111111111111111111111111111111111111111111111111111111
111111111111111111111111111111111111111111111111111111111111
111111111111111111111111111111111111111111111111111111111111