1111111111111111111111111111111111111111
1000000000000000000000000000000000000011
1000000101001110100010000110000000000011
1000000111001100100010001001000000000011
1000000101001110111011100110000000000011
1000000000000000000000000000000000000011
1001C00000001111111111111111000000000011
1000011111001111111111111111000000000011
1000111E0C000000000000000001000000000011
1111111111111111111111111111CCCCCCCCCC11
1111111111111111111111111111000000000011
1111111011111111111111111111000000000011
1111111111111111111111111111000000000011
1111111111111111111111111111000000000011
1111111111111111111111111111011100000011
1111111111111111111111111111100010000011
1111111111111111111111111111001010000011
1111111111111111111111111111P10000000011
1111111111111111111111111111111111111111